#########################
#  #                    #
#                       #
#           #           #
#   #       #           #
#    #      #           #
#     #                 #
#           ###         #
#                       #
#           #           #
#           #           #
#           #           #
#  ###                  #
#                       #
#########################