#########################
#                       #
#           #           #
#                       #
#                       #
#                       #
#                       #
#  #        #        #  #
#                       #
#                       #
#                       #
#                       #
#           #           #
#                       #
#########################