#########################
#                       #
#                       #
#           #           #
#           #           #
#           #           #
#                       #
#   ###     #     ###   #
#                       #
#           #           #
#           #           #
#           #           #
#                       #
#                       #
#########################